GERAL

cd - descer diretório
cd.. - sobe diretório
dir - mostra diretorios
cd\ - vai pro diretorio raiz
cls - limpa 
md - cria diretorio
copy - copia arquivo ou diretorio
del - deleta arquivo
rd - deleta diretorio vazio
rd /s - deleta diretorio e subpastas nele
erase - deleta arquivos
start - executa 
ren - renomear arquivos ( ex: ren imagem.jpg fotos.jpg )
shutdown - desligar o pc
systeminfo - mostra informaçoes sobre o sistema
tasklist - mostra lista de processos sendo executados
print - imprime um arquivo e texto
exit - fecha o cmd

GIT

git clone - copia um repositorio do browser para a maquina
git pull - atualiza os conteudos do repositorio na maquina
git add . - adiciona arquivos ou pastas para o diretorio do repositorio
git commit -m "" - faz um commit
git push - joga suas alteracoes do repositorio na maquina para o github
git branch - fala em qual ramo esta 
git checkout branch - muda para o branch escolhido
git branch -d branch - apaga o branch
git merge branch - faz o merge do branch atual com o escolhido
git branch --list - lista os ramos